1111111111
1@00000001
1010111101
10101*0#01
1010111101
1000000001
1111111101
1#000*0101
120*010001
1111111111