111111111111111111111111111111111
10000000**00100000000000000000001
101111111101111011111111111111101
10@000000000000000000000000000021
101110111111011111011111111111101
100000000000100001000000000000001
101111011111011111111101111111101
100000000000000000000000000000001
101111111101111011111111101111101
100000000000100001000000000000001
101111011111011111011111111111101
10#000000000000000000000000000001
101111111101111*11111111101111101
100000000000000000000000000000001
101111011111011111011111111111101
100000000*00000000000000000000001
101111111101111011111111111111101
100000000000000000000000000000001
101111011111011111011111111111101
100000000000000000000000000000001
101111111101111011111111111111101
100000000*00000000000000000000001
111111111111111111111111111111111
