1111111111111111111
1000000000000000001
1011110111110111101
10@0000000000000021
1011101111111111101
100000000*000000001
1011110111110111101
1000000000000000001
1111111111111111111
