1111111111111111
1@000000*00000#1
1010111101111111
1010100000000#11
1010111111110111
10*0100000000101
11111011111111*1
1#00000000*00001
1011111111111101
10000000*0000001
1010111111111101
10101000*0000#01
1110101111111101
1011100101000101
1200*00100010*01
1111111111111111