1111111111111
1@00000000001
1010111111111
10101000*0#01
1010111111101
1010000*00001
1111111111101
1#000000*0001
1011111111101
10100*0000001
121000*000001
1111111111111